Survey Year,Team,State,Players,Operating Expenses per Participant,Operating Expenses,Total Revenues,Total Expenses,Net Revenue
2014,Appalachian State University,NC,110,8484,933229,5947165,5947165,0
2014,Arizona State,AZ,121,62414,7552151,49016140,28083384,20932756
2014,Arkansas State University-Main Campus,AR,122,12811,1562898,6501109,6501109,0
2014,Auburn,AL,122,35648,4349056,86742256,40077352,46664904
2014,Ball State University,IN,119,13666,1626207,7061205,7061205,0
2014,Baylor,TX,113,46448,5248575,35575376,28433715,7141661
2014,Boise State,ID,107,26426,2827603,20206989,8839739,11367250
2014,Boston College,MA,93,53910,5013592,27232643,21853965,5378678
2014,Bowling Green State University-Main Campus,OH,104,12741,1325101,6574521,6574467,54
2014,Brigham Young University-Provo,UT,128,22258,2849014,19902453,14634364,5268089
2014,California State University-Fresno,CA,112,27488,3078693,13552228,10980347,2571881
2014,Central Michigan University,MI,115,15079,1734074,6971102,6971102,0
2014,Clemson,SC,115,40264,4630343,43959747,24191774,19767973
2014,Colorado State University-Fort Collins,CO,116,26006,3016695,13002269,13002269,0
2014,Duke University,NC,114,29762,3392912,32407399,22915934,9491465
2014,East Carolina University,NC,126,28388,3576933,12299240,11355294,943946
2014,Eastern Michigan University,MI,107,8764,937703,6291437,6259439,31998
2014,Florida Atlantic University,FL,115,15948,1834045,7659353,7628818,30535
2014,Florida International University,FL,101,15487,1564204,9157416,9157416,0
2014,Florida State,FL,120,89909,10789051,70321194,31299768,39021426
2014,Georgia Tech,GA,116,39777,4614135,41124340,19682945,21441395
2014,Georgia Southern University,GA,135,6808,919084,4777968,4777968,0
2014,Georgia State University,GA,125,19332,2416441,6664116,6664116,0
2014,Indiana University-Bloomington,IN,136,18362,2497266,27508477,18010927,9497550
2014,Iowa State University,IA,126,23891,3010211,33074046,15420583,17653463
2014,Kansas State,KS,128,23909,3060364,34725916,16967110,17758806
2014,Kent State University at Kent,OH,106,9684,1026554,5652301,5497223,155078
2014,LSU,LA,120,30877,3705213,86312831,28639663,57673168
2014,Louisiana Tech University,LA,100,22132,2213208,7473142,7341453,131689
2014,Marshall University,WV,106,16001,1696113,9038549,7912066,1126483
2014,Miami University-Oxford,OH,115,11009,1266004,8172656,8172654,2
2014,Michigan State,MI,115,54950,6319252,59227831,27694367,31533464
2014,Middle Tennessee State University,TN,142,13889,1972219,9054880,9054880,0
2014,Mississippi State,MS,109,23051,2512581,31308423,17213521,14094902
2014,New Mexico State University-Main Campus,NM,117,17822,2085145,6375298,6375298,0
2014,North Carolina Central University,NC,125,4145,518071,3397443,3397443,0
2014,North Carolina State University at Raleigh,NC,115,13582,1561961,39999142,17833208,22165934
2014,Northern Illinois University,IL,113,15645,1767843,8268043,8268043,0
2014,Northwestern University,IL,110,24976,2747342,31664655,20884258,10780397
2014,Ohio State,OH,118,86065,10155684,83547428,32588493,50958935
2014,Ohio University-Main Campus,OH,120,7213,865609,8011239,7745655,265584
2014,Oklahoma State University-Main Campus,OK,135,25295,3414866,43778793,19523281,24255512
2014,Old Dominion University,VA,125,16840,2105030,8709737,8709737,0
2014,Oregon State University,OR,105,20076,2107942,30916950,14690714,16226236
2014,Pennsylvania State University-Main Campus,PA,115,83665,9621531,71305219,35146623,36158596
2014,Purdue University-Main Campus,IN,105,32725,3436142,17073335,15598196,1475139
2014,Rice University,TX,111,23646,2624662,13010450,13010445,5
2014,Rutgers University-New Brunswick,NJ,111,45789,5082634,26903695,20158193,6745502
2014,San Diego State University,CA,127,22979,2918358,12459848,13364530,-904682
2014,San Jose State University,CA,108,17876,1930613,6490966,6490966,0
2014,Southern Methodist University,TX,111,13300,1476350,16448366,16448366,0
2014,Stanford University,CA,113,25969,2934534,37519312,19912411,17606901
2014,Syracuse University,NY,114,23803,2713537,41877234,19809300,22067934
2014,Temple University,PA,124,25402,3149852,14247503,14247503,0
2014,Texas A & M University-College Station,TX,119,30930,3680669,62199166,25670784,36528382
2014,TCU,TX,127,54757,6954177,41259536,33751213,7508323
2014,Texas State University,TX,120,16227,1947235,6320336,6320336,0
2014,Texas Tech University,TX,127,28100,3568666,39266665,20955929,18310736
2014,Alabama,AL,130,61128,7946626,97023963,51044292,45979671
2014,The University of Tennessee-Knoxville,TN,135,29292,3954428,94377857,24511032,69866825
2014,The University of Texas at Austin,TX,126,50184,6323198,121382436,29814804,91567632
2014,The University of Texas at El Paso,TX,108,23324,2518979,11636472,9205444,2431028
2014,The University of Texas at San Antonio,TX,117,23423,2740461,8564222,8564222,0
2014,Troy University,AL,147,7182,1055753,6962876,6962876,0
2014,Tulane University of Louisiana,LA,114,11356,1294556,8980759,11293759,-2313000
2014,University at Buffalo,NY,107,11233,1201975,7259746,7259746,0
2014,University of Akron Main Campus,OH,105,8577,900581,7155103,7155103,0
2014,University of Alabama at Birmingham,AL,135,6350,857251,6933407,6856361,77046
2014,Arizona,AZ,125,45090,5636229,23115960,20422820,2693140
2014,University of Arkansas,AR,120,45270,5432353,66179978,30795322,35384656
2014,University of California-Berkeley,CA,134,39351,5273040,43651316,21802870,21848446
2014,UCLA,CA,123,65451,8050416,44727001,26858792,17868209
2014,University of Central Florida,FL,125,32809,4101139,23626498,18051303,5575195
2014,University of Cincinnati-Main Campus,OH,112,28484,3190182,13821277,13821277,0
2014,University of Colorado Boulder,CO,112,35962,4027733,28313259,17039193,11274066
2014,University of Connecticut,CT,99,43331,4289724,8308332,14225947,-5917615
2014,University of Florida,FL,109,72982,7955037,74720732,37473203,37247529
2014,Georgia,GA,122,48783,5951527,86719115,26154335,60564780
2014,University of Hawaii at Manoa,HI,110,24241,2666488,10716179,10716179,0
2014,University of Houston,TX,110,21947,2414124,11306212,11306212,0
2014,University of Idaho,ID,101,18088,1826838,6204214,6123773,80441
2014,University of Illinois at Urbana-Champaign,IL,110,25716,2828708,30819615,18336909,12482706
2014,University of Iowa,IA,121,39883,4825833,52354781,25482299,26872482
2014,University of Kansas,KS,91,31326,2850656,25986541,20793566,5192975
2014,University of Kentucky,KY,129,17696,2282744,35495890,19033843,16462047
2014,University of Louisiana at Lafayette,LA,128,18833,2410680,7953169,7953169,0
2014,University of Louisiana at Monroe,LA,97,10879,1055269,4071730,4071730,0
2014,Louisville,KY,122,32330,3944304,36383759,18654530,17729229
2014,University of Maryland-College Park,MD,107,26786,2866106,30891641,16151389,14740252
2014,University of Massachusetts-Amherst,MA,110,13448,1479275,7027529,7027529,0
2014,University of Memphis,TN,117,16987,1987502,13376999,13376999,0
2014,University of Miami,FL,111,57899,6426835,38985460,26894656,12090804
2014,University of Michigan-Ann Arbor,MI,117,37768,4418872,88251525,31880547,56370978
2014,Minnesota,MN,126,39300,4951745,35772983,26292215,9480768
2014,Ole Miss,MS,123,38458,4730304,53399653,25164361,28235292
2014,Missouri,MO,127,44806,5690424,37892973,23318033,14574940
2014,University of Nebraska-Lincoln,NE,138,48611,6708264,60621628,29179492,31442136
2014,University of Nevada-Las Vegas,NV,108,13493,1457226,8954365,8954365,0
2014,University of Nevada-Reno,NV,114,18912,2155938,8252434,7087956,1164478
2014,University of New Mexico-Main Campus,NM,116,16827,1951948,7677165,7677165,0
2014,University of North Carolina at Chapel Hill,NC,129,30135,3887361,36050976,21741635,14309341
2014,University of North Carolina at Charlotte,NC,104,9229,959805,5834689,5834689,0
2014,University of North Texas,TX,103,16160,1664496,8348300,5112509,3235791
2014,University of Notre Dame,IN,109,66532,7252022,86125989,31872250,54253739
2014,University of Oklahoma-Norman Campus,OK,117,50584,5918354,78737409,30316609,48420800
2014,Oregon,OR,110,36252,3987730,60956894,20679336,40277558
2014,University of Pittsburgh-Pittsburgh Campus,PA,108,49955,5395162,34089376,22314576,11774800
2014,University of South Alabama,AL,133,12211,1624028,8548788,8382537,166251
2014,University of South Carolina-Columbia,SC,110,27182,2990022,59768622,31357215,28411407
2014,University of South Florida-Main Campus,FL,115,23259,2674801,10694740,12016829,-1322089
2014,Southern Cal,CA,112,91554,10254029,45886944,30575240,15311704
2014,University of Southern Mississippi,MS,120,9516,1141974,7631061,7631061,0
2014,University of Toledo,OH,105,19589,2056878,8171693,8171693,0
2014,University of Tulsa,OK,126,11588,1460086,15108680,15108680,0
2014,Utah,UT,125,35887,4485879,42931079,19553655,23377424
2014,University of Virginia-Main Campus,VA,111,32036,3555956,24551003,18083383,6467620
2014,University of Washington-Seattle Campus,WA,106,85157,9026631,66941640,29136569,37805071
2014,Wisconsin,WI,112,39455,4419012,44797138,26643793,18153345
2014,University of Wyoming,WY,116,12360,1433752,11008232,8061049,2947183
2014,Utah State University,UT,112,17720,1984678,7992075,7992075,0
2014,Vanderbilt University,TN,107,26442,2829245,27409392,24136525,3272867
2014,Virginia Polytechnic Institute and State University,VA,141,25688,3622023,50387116,26818875,23568241
2014,Wake Forest University,NC,107,19601,2097270,20797837,15440704,5357133
2014,Washington State University,WA,139,23719,3296989,32004916,16638375,15366541
2014,West Virginia University,WV,131,34688,4544144,22510492,17367769,5142723
2014,Western Kentucky University,KY,134,7857,1052817,7227022,7227022,0
2014,Western Michigan University,MI,107,14431,1544131,8041489,8041487,2